PPPPPPPPPPPPPPPPPPPP
PPPPPPPPPPPPPPPPPPPP
PPPPPPPPPPPPPPPPPPPP
PPPPPPPPPPPPPPPPPPPP
PPPPPPPPPPPPPPPPPPPP
PPPPPPPPPPPPPPPPPPPR
PPPPPPPRPPPPPPPPPPPP
PPPPPPRTRPPPPPPPPPPP
PPPPPPPRPPPPPPPPPPPP
PPPPPPPPPPPPPPPPPPPP
PPPPPPPPPPPPPPPPPPPP
PPPPPPPRPPPPPPPPPPPP
PPPPPPRIRPPPPPPPPPPP
PPPPPPPRPPPPPPPPPPPP
PPPPPPPPPPPPPPPPPPPP
AAAAAAAPPPPPPPPPPPPP
AAAAAAAPPPPPPPPPPPPP
AAAAAAAPPPPPPPPPPPPP
AAAAAAAPPPPPPPPPPPPP
AAAAAAAPPPPPPPPPPPPP