0000000ds00000000000
00000000d00000000000
00000000d00000000000
00000000d00000000000
00000000d00000000000
0000000dl00000000000
r000000d000000000000
srrrrrr0llllllllllls
0000000ullllll000000
0000000000000ul00000
00000000000000ul0000
000000000000000ul000
0000000000000000ull0
000000000000000000ul
000000000000000000us
00000000000000000000
00000000000000000000
00000000000000000000
00000000000000000000
00000000000000000000