PPPPPPPPPPPPPPPPPPPPPPPPPPPPPP
AAAAAAAAPPPPPPPPPAAAAAAAAAAAAP
AAAAAAAAPRRRRPPPPAAAAAAAAAAAAP
AAAAAAAPPRRIRPPPPAAAAAAAAAAAAP
AAAAAAAAPRRRRPPPPAAAAAAAAAAAAP
AAAAAAAAPPPPPPPPPAAAAAAAAAAAAP
PPPPPPPPPPPPPPPPPPPPPPPPPPPPPP
PPPPPPPPPPPPPPPPPPPPPPPPPPPPPP
AAAAAAAAPPPPPPPPPAAAAAAAAAAAAP
AAAAAAAAPRRRRPPPPAAAAAAAAAAAAP
AAAAAAAPPRRIRPPPPAAAAAAAAAAAAP
AAAAAAAAPRRRRPPPPAAAAAAAAAAAAP
AAAAAAAAPPPPPPPPPAAAAAAAAAAAAP
PPPPPPPPPPPPPPPPPPPPPPPPPPPPPP
PPPPPPPPPPPPPPPPPPPPPPPPPPPPPP
AAAAAAAAPPPPPPPPPAAAAAAAAAAAAP
AAAAAAAAPRRRRPPPPAAAAAAAAAAAAP
AAAAAAAPPRRIRPPPPAAAAAAAAAAAAP
AAAAAAAAPRRRRPPPPAAAAAAAAAAAAP
AAAAAAAAPPPPPPPPPAAAAAAAAAAAAP
PPPPPPPPPPPPPPPPPPPPPPPPPPPPPP
PPPPPPPPPPPPPPPPPPPPPPPPPPPPPP
AAAAAAAAPPPPPPPPPAAAAAAAAAAAAP
AAAAAAAAPRRRRPPPPAAAAAAAAAAAAP
AAAAAAAPPRRIRPPPPAAAAAAAAAAAAP
AAAAAAAAPRRRRPPPPAAAAAAAAAAAAP
AAAAAAAAPPPPPPPPPAAAAAAAAAAAAP
PPPPPPPPPPPPPPPPPPPPPPPPPPPPPP
PPPPPPPPPPPPPPPPPPPPPPPPPPPPPP
PPPPPPPPPPPPPPPPPPPPPPPPPPPPPP