PPPPPPPPPPPPPPPPPPPPPPPPPPPPP
PPPPPPAAAPPPPPPPPPPPPPPPPPPPP
PPPPPPAAAPPPPPPPPPPPPPPPPPPPP
PPPPPPAAAPPPPPPPPPPPPPPPPPPPP
PPPPPPPPPPPPPPPPPPPPPPPPPPPPP
PPPPPPPPPPPPPPPPPPPRPPPPPPPPP
PPPPPPPPPPPPPPPPPPRIRPPPPPPPP
PPPPPPPPPPPPPPPPPPPRPPPPPPPPP
PPPPPPPPPPPPPPPPPPPPPPPPPPPPP
PPPPPPPPPPPPPPPPPPPPPPPPPPPPP
AAAAAAAPPPPPPPPPPPPPPPPPPPPPP
AAAAAAAPPPPPPRRPPPPPPPPPPPPPP
AAAAAAAPPPPPRTTRPPPPPPPPPPPPP
PPPPPPPPPPPPRTTTRPPPPPPPPPPPP
PPPPPPPPPPPPPRRRPPPPPPPPPPPPP
PPPPPPPPPPPPPPPPPPPPPPPPPPPPP
PPPPPPPPPPPPPPPPPPPPPPPPPPPPP
PPPPPPPPPPPPPPPPPPPPPPPPPPPPP
PPPPPPAAAAAAAPPPPPPPPPPPPPPPP
PPPPPPAAAAAAAPPPPPPPPPPPPPPPP
PPPPPPAAAAAAAPPPPPPPPPPPPPPPP
PPPPPPAAAAAAAPPPPPPPPPPPPPPPP
PPPPPPPPPPPPPPPPPPPPPPPPPPPPP
PPPPPPPPPPPPPPPPPPPPPPPPPPPPP
PPPPPPPPPPPPPPPPPPPPPPPPPPPPP
PPPPPPPPPPPPPPPPPPPPPPPPPPPPP
PPPPPPPPPPPPPPPPPPPPPPPPPPPPP
PPPPPPPPPPPPPPPPPPPPPPPPPPPPP
