PPPPPPPPPPPPPPPPPPPPPPPPPPPPPP
PPPPPPAAAPPPPPPPPPPPPPPPPPPPPP
PPPPPPAAAPPPPPPPPPPPPPPPPPPPPP
PPPPPPAAAPPPPPPPPPPPPPPPPPPPPP
PPPPPPPPPPPPPPPPPPPPPPPPPPPPPP
PPPPPPPPPPPPPPPPPPPRPPPPPPPPPP
PPPPPPPPPPPPPPPPPPRIRPPPPPPPPP
PPPPPPPPPPPPPPPPPPPRPPPPPPPPPP
PPPPPPPPPPPPPPPPPPPPPPPPPPPPPP
PPPPPPPPPPPPPPPPPPPPPPPPPPPPPP
AAAAAAAPPPPPPPPPPPPPPPPPPPPPPP
AAAAAAAPPPPPPRRPPPPPPPPPPPPPPP
AAAAAAAPPPPPRTTRPPPPPPPPPPPPPP
PPPPPPPPPPPPRTTTRPPPPPPPPPPPPP
PPPPPPPPPPPPPRRRPPPPPPPPPPPPPP
PPPPPPPPPPPPPPPPPPPPPPPPPPPPPP
PPPPPPPPPPPPPPPPPPPPPPPPPPPPPP
PPPPPPPPPPPPPPPPPPPPPPPPPPPPPP
PPPPPPAAAAAAAPPPPPPPPPPPPPPPPP
PPPPPPAAAAAAAPPPPPPPPPPPPPPPPP
PPPPPPAAAAAAAPPPPPPPPPPPPPPPPP
PPPPPPAAAAAAAPPPPPPPPPPPPPPPPP
PPPPPPPPPPPPPPPPPPPPPPPPPPPPPP
PPPPPPPPPPPPPPPPPPPPPPPPPPPPPP
PPPPPPPPPPPPPPPPPPPPPPPPPPPPPP
PPPPPPPPPPPPPPPPPPPPPPPPPPPPPP
PPPPPPPPPPPPPPPPPPPPPPPPPPPPPP
PPPPPPPPPPPPPPPPPPPPPPPPPPPPPP
AAAAAAAAAAAAAAAAAAAAAAAAAAAAAA
AAAAAAAAAAAAAAAAAAAAAAAAAAAAAA